5 10	
1111111111
1000000001
1222222221
1000000001
1111111111