6 11
1111111111
1000000001
1222222221
1000000001
1222222221
1111111111